R 9054540 335435400
NO ./textures/greystone.xpm
SO ./textures/eagle.xpm
WE ./textures/purplestone.xpm
EA ./textures/mossy.xpm
S ./textures/barrel.xpm
F 37,75,0
C 0,204,255

             
        1111111111111111111111111
        1000000000110000000200001
        1011000001110000002220001
        100100E000000000000200001
111111111011000001110000000000001
100000000011000001110111111111111
11110111111111011100000010001
11110111111111011101010010001
11000000110101011100000010001
10002000000000001100000010201
10000000000000001101010010001
11000001110101011111011111111
11110111 1110101 101111010001
11111111 1111111 111111111111
